11111111111111111111111111
11C000000001100C0000001111
1111011100111E0010100C0111
1C1101C11C11111110100C0011
10010000001C000C1100000001
1P0100M0011000001000000001
10000000000110111000001011
101001011100C0001000000C11
10100100001000001010001001
10011101111000100010111011
100001010C0000111110000001
1C10C100111000011110111C11
11111111111111111111111111